xx11111111
xx10000001
1110000001
1000001001
10N0000001
1111111111
